--------------Sonucu None Verenler-------------------
EDAT VE BAĞLAÇ
CC: coordinating conjunction -> Bağlaç
IN: preposition or conjunction -> Edat veya Bağlaç
TO: to go 'to' the store. -> Edat
ZAMİR VE ZARF
PRP: personal pronoun I, he, she -> Zamir
PRP$: possessive pronoun my, his, hers -> >Zamir
RB: adverb very, silently, -> Zarf
RBR: adverb, comparative better -> Zarf
RBS: adverb, superlative best -> Zarf
UH: interjection errrrrrrrm -> Ünlem
WDT: wh-determiner which -> Wh zarfı
WP: wh-pronoun who, what -> WH zamiri
WRB: wh-abverb where, when -> Wh zarfı
DT: determiner -> Belirleyici
EX: existential there (like "there is" ... think of it like "there exists")
LS: list marker  -> Liste Öğesi
MD: modal could, will -> Mod Yardımcısı
PDT: predeterminer 'all the kids' ->  Ön Belirleyici
POS: possessive ending parent\'s  -> Tırnak
JJ: adjective 'big' ->Sıfat
JJR: adjective, comparative 'bigger' -> Sıfat , Karşılaştırmalı
JJS: adjective, superlative 'biggest' -> Sıfat, Üstünlük

-------------------NOUN VE VERB KARŞILIĞI VEREN TAGLER-----------------
NN: noun, singular 'desk' -> İsim
NNS: noun plural 'desks' -> İsim
NNP: proper noun, singular 'Harrison' -> İsim
NNPS: proper noun, plural 'Americans' -> İsim
RP: particle give up -> parçacık
CD: cardinal digit -> Sayısal Verilerin Karşılığı
VBD: verb, past tense took -> Fiil
VBG: verb, gerund/present participle taking -> Fiil
VBN: verb, past participle taken -> Fiil
VBP: verb, sing. present, non-3d take -> Fiil
VBZ: verb, 3rd person sing. present takes -> Fiil
VB: verb, base form take -> Fiil








